R 1920 1080
NO ./text/bluestone.xpm
SO ./text/colorstone.xpm
WE ./text/greystone.xpm
EA ./text/redbrick.xpm


S ./text/barrel.xpm

F 242,35,13
C 255,213,00

        1111111111111111111111111
        10000000001100S0000222001
        1011000001110000002002001
        1001000000000000000000001
111111111011000001110000000000001
100000000011000001110111111111111
11110111111111011100000010001
11100111111111111101010010001
11000000110101110000001000111
1202000000000011100000010001
10000000000000000000000000111
1100000111010101111101111000111
11110111 1110101 101111010001
11111111 1111111 111111111111